1 1 1 1 1 1 1 1 1 1 1 1 1 1 1 1 
1 0 0 0 3 0 0 0 0 0 0 0 0 0 0 1
1 0 0 0 3 0 0 0 0 0 0 0 0 0 0 1
1 0 0 0 3 0 0 0 0 0 0 0 0 0 0 1
1 0 0 0 3 0 0 0 0 0 0 0 0 0 0 1
1 3 0 3 3 0 0 0 0 0 0 0 0 0 0 1
1 0 0 0 0 0 0 0 0 0 0 0 0 0 0 1
1 0 0 0 0 0 0 0 0 0 0 0 0 0 0 1
1 0 0 0 0 0 0 0 0 0 0 0 0 0 0 1
1 0 0 0 0 0 0 0 0 0 0 0 0 0 0 1
1 0 0 0 0 0 0 0 0 0 0 0 0 0 0 1
1 0 0 0 0 0 0 0 0 0 0 0 0 0 0 1
1 0 0 0 0 0 0 0 0 0 0 0 0 0 0 1
1 0 0 0 0 0 0 0 0 0 0 0 0 0 0 1
1 0 0 0 0 0 0 0 0 0 0 0 0 0 0 1
1 1 1 1 1 1 1 1 1 1 1 1 1 1 1 1 
OBJECTS_LOADING:
PLAYER 2.5 1.5 0 1
FIRE_WIZARD 2.5 13.5
FIRE_WIZARD 5.5 13.5
FIRE_WIZARD 8.5 13.5
FIRE_WIZARD 11.5 13.5
FIRE_WIZARD 14.5 13.5
FIRE_WIZARD 14.5 10.5
FIRE_WIZARD 14.5 7.5
FIRE_WIZARD 14.5 4.5
FIRE_WIZARD 14.5 1.5
SODA 1.5 1.5
SODA 1.5 1.75
SODA 1.5 2.0
HAMBURGER 3.5 1.5
HAMBURGER 3.5 1.75
HAMBURGER 3.5 2.0
AMMO_PISTOL 3.5 4.0
AMMO_PISTOL 3.5 4.25
AMMO_PISTOL 3.5 4.5
AMMO_SHOTGUN 1.5 4.0
AMMO_SHOTGUN 1.5 4.25
AMMO_SHOTGUN 1.5 4.5